accouterments=accoutrements
eon=aeon
eons=aeons
aerogram=aerogramme
aerograms=aerogrammes
airplane=aeroplane
airplanes=aeroplanes
esthete=aesthete
esthetes=aesthetes
esthetic=aesthetic
esthetically=aesthetically
esthetics=aesthetics
etiology=aetiology
aggrandizement=aggrandisement
almanac=almanack
almanacs=almanacks
aluminum=aluminium
amphitheater=amphitheatre
amphitheaters=amphitheatres
anemia=anaemia
anemic=anaemic
anesthesia=anaesthesia
anesthetic=anaesthetic
anesthetics=anaesthetics
anesthetize=anaesthetize
anesthetized=anaesthetized
anesthetizes=anaesthetizes
anesthetizing=anaesthetizing
anesthesiologist=anaesthetist
anesthetist=anaesthetist
anesthetists=anaesthetists
anesthetize=anaesthetize
anesthetized=anaesthetized
anesthetizes=anaesthetizes
anesthetizing=anaesthetizing
analog=analogue
analogs=analogues
analyze=analyse
analyzed=analysed
analyzer=analyser
analyzes=analyses
analyzing=analysing
antennas=antennae
antialiased=anti-aliased
antialiasing=anti-aliasing
counter-clockwise=anti-clockwise
counterclockwise=anti-clockwise
appall=appal
appalls=appals
arbor=arbour
arbors=arbours
archeological=archaeological
archeologically=archaeologically
archeologist=archaeologist
archeologists=archaeologists
archeology=archaeology
ardor=ardour
armor=armour
armored=armoured
armorer=armourer
armorers=armourers
armories=armouries
armory=armoury
artifact=artefact
artifacts=artefacts
backpedaled=backpedalled
backpedaling=backpedalling
banister=bannister
banisters=bannisters
battleax=battleaxe
balk=baulk
balked=baulked
balking=baulking
balks=baulks
bedeviled=bedevilled
bedeviling=bedevilling
behavior=behaviour
behavioral=behavioural
behaviorism=behaviourism
behaviorist=behaviourist
behaviorists=behaviourists
behaviors=behaviours
behoove=behove
behooved=behoved
behooves=behoves
bejeweled=bejewelled
belabor=belabour
belabored=belaboured
belaboring=belabouring
belabors=belabours
beveled=bevelled
bevies=bevvies
bevy=bevvy
binging=bingeing
bougainvillea=bougainvillaea
bougainvilleas=bougainvillaeas
breathalyze=breathalyse
breathalyzed=breathalysed
breathalyzer=breathalyser
breathalyzers=breathalysers
breathalyzes=breathalyses
breathalyzing=breathalysing
cesarean=caesarean
cesareans=caesareans
caliber=calibre
calibers=calibres
caliper=calliper
calipers=callipers
calisthenics=callisthenics
cancelation=cancellation
cancelations=cancellations
canceled=cancelled
canceling=cancelling
candor=candour
parking lot=car park
caroled=carolled
caroling=carolling
case insensitive=case-insensitive
case sensitive=case-sensitive
catalog=catalogue
catalog=catalogue
catalog.=catalogue.
cataloged=catalogued
catalogs=catalogues
cataloging=cataloguing
catalyze=catalyse
catalyzed=catalysed
catalyzes=catalyses
catalyzing=catalysing
caviled=cavilled
caviling=cavilling
centigram=centigramme
centigrams=centigrammes
centiliter=centilitre
centiliters=centilitres
centimeter=centimetre
centimeters=centimetres
center=centre
centered=centred
centerfold=centrefold
centerfolds=centrefolds
centerpiece=centrepiece
centerpieces=centrepieces
centers=centres
centering=centring
channeled=channelled
channeling=channelling
shivaree=charivari
checkbook=chequebook
checkbooks=chequebooks
checker=chequer
checkerboard=chequerboard
checkered=chequered
chili=chilli
chimera=chimaera
chimeras=chimaeras
chiseled=chiselled
chiseling=chiselling
clamor=clamour
clamored=clamoured
clamoring=clamouring
clamors=clamours
clangor=clangour
clarinetist=clarinettist
clarinetists=clarinettists
cooperate=co-operate
coordinate=co-ordinate
color=colour
colorkey=colour-key
colorspace=colour-space
colorant=colourant
colorants=colourants
colored=coloured
coloreds=coloureds
colorer=colourer
colorful=colourful
colorfully=colourfully
coloring=colouring
colorize=colourize
colorized=colourized
colorizes=colourizes
colorizing=colourizing
colorless=colourless
colors=colours
connection=connexion
connections=connexions
cozier=cosier
cozies=cosies
coziest=cosiest
cozily=cosily
coziness=cosiness
cozy=cosy
councilor=councillor
councilors=councillors
counseled=counselled
counseling=counselling
counselor=counsellor
counselors=counsellors
coupe=coupé
crenelated=crenellated
crueler=crueller
cruelest=cruellest
cudgeled=cudgelled
cudgeling=cudgelling
curriculums=curricula
cipher=cypher
ciphers=cyphers
dealed=dealt
defense=defence
defenseless=defenceless
defenses=defences
demeanor=demeanour
dialed=dialled
dialer=dialler
dialing=dialling
dialog=dialogue
dialogs=dialogues
diarrhea=diarrhoea
disk=disc
disk-=disc-
disk,=disc,
disk;=disc;
disk.=disc.
discolor=discolour
discolored=discoloured
discoloring=discolouring
discolors=discolours
disks=discs
disky=discy
disemboweled=disembowelled
disemboweling=disembowelling
disfavor=disfavour
disheveled=dishevelled
dishonor=dishonour
dishonorable=dishonourable
dishonorably=dishonourably
dishonored=dishonoured
dishonoring=dishonouring
dishonors=dishonours
distill=distil
distills=distils
donut=doughnut
draftboard=draughtboard
draftboards=draughtboards
draftier=draughtier
draftiest=draughtiest
drafts=draughts
draftsman=draughtsman
draftsmanship=draughtsmanship
draftsmen=draughtsmen
draftswoman=draughtswoman
draftswomen=draughtswomen
drafty=draughty
dreamed=dreamt
driveled=drivelled
driveling=drivelling
dueled=duelled
dueling=duelling
edema=edoema
enameled=enamelled
enameling=enamelling
enamored=enamoured
encyclopedia=encyclopaedia
encyclopedias=encyclopaedias
encyclopedic=encyclopaedic
endeavor=endeavour
endeavored=endeavoured
endeavoring=endeavouring
endeavors=endeavours
enroll=enrol
enrolls=enrols
enthrall=enthral
enthralls=enthrals
epaulet=epaulette
epaulets=epaulettes
epicenter=epicentre
epicenters=epicentres
epilog=epilogue
epilogs=epilogues
equaled=equalled
equaling=equalling
fecal=faecal
feces=faeces
faucet=tap
favor=favour
favorable=favourable
favorably=favourably
favored=favoured
favoring=favouring
favorite=favourite
favorites=favourites
favoritism=favouritism
favors=favours
fervor=fervour
fiber=fibre
fiberglass=fibreglass
fibers=fibres
filet=fillet
fileted=filleted
fileting=filleting
filets=fillets
movie=film
flutist=flautist
flutists=flautists
flavor=flavour
flavored=flavoured
flavoring=flavouring
flavorings=flavourings
flavorless=flavourless
flavors=flavours
flavorsome=flavoursome
flier/flyer=flyer/flier
fetal=foetal
fetid=foetid
fetus=foetus
fetuses=foetuses
formulas=formulae
upcoming=forthcoming
fueled=fuelled
fueling=fuelling
fulfill=fulfil
fulfillment=fulfilment
fulfills=fulfils
funneled=funnelled
funneling=funnelling
furor=furore
gamboled=gambolled
gamboling=gambolling
jail=gaol
jailbird=gaolbird
jailbirds=gaolbirds
jailbreak=gaolbreak
jailbreaks=gaolbreaks
gypsies=gipsies
glamor=glamour
globaly=globally
gluing=glueing
glycerin=glycerine
goiter=goitre
goiters=goitres
gonorrhea=gonorrhoea
graveled=gravelled
gray=grey
grayed=greyed
graying=greying
grayish=greyish
graylist=greylist
graylisted=greylisted
graylisting=greylisting
grayness=greyness
grays=greys
groveled=grovelled
groveling=grovelling
groin=groyne
groins=groynes
grueling=gruelling
gruelingly=gruellingly
griffin=gryphon
griffins=gryphons
guerilla=guerrilla
gynecological=gynaecological
gynecologist=gynaecologist
gynecologists=gynaecologists
gynecology=gynaecology
hematological=haematological
hematologist=haematologist
hematologists=haematologists
hematology=haematology
hemoglobin=haemoglobin
hemophilia=haemophilia
hemophiliac=haemophiliac
hemophiliacs=haemophiliacs
hemorrhage=haemorrhage
hemorrhaged=haemorrhaged
hemorrhages=haemorrhages
hemorrhaging=haemorrhaging
hemorrhoids=haemorrhoids
harbor=harbour
harbored=harboured
harboring=harbouring
harbors=harbours
hauler=haulier
homeopath=homoeopath
homeopathic=homoeopathic
homeopaths=homoeopaths
homeopathy=homoeopathy
honor=honour
honorable=honourable
honorably=honourably
honored=honoured
honoring=honouring
honors=honours
humor=humour
humored=humoured
humoring=humouring
humorless=humourless
humors=humours
impaneled=impanelled
impaneling=impanelling
imperiled=imperilled
imperiling=imperilling
inflection=inflexion
inflections=inflexions
initialed=initialled
initialing=initialling
install=instal
installment=instalment
installments=instalments
installs=instals
instill=instil
instills=instils
jeweled=jewelled
jeweler=jeweller
jewelers=jewellers
jewelery=jewellery
jewelry=jewellery
journaling=journalling
judgment=judgement
kilogram=kilogramme
kilograms=kilogrammes
kilometer=kilometre
kilometers=kilometres
kneeled=knelt
labeled=labelled
labeler=labeller
labeling=labelling
labor=labour
labored=laboured
laborer=labourer
laborers=labourers
laboring=labouring
labors=labours
lackluster=lacklustre
ladybug=ladybird
learned=learnt
leaped=lept
mailbox=letterbox
leukemia=leukaemia
leveled=levelled
leveler=leveller
levelers=levellers
leveling=levelling
libeled=libelled
libeling=libelling
libelous=libellous
license=licence
licensed=licenced
licenses=licences
licensing=licencing
likable=likeable
lighted=lit
liter=litre
liter=litre
liter=litre
liters=litres
louver=louvre
louvered=louvred
louvers=louvres
maneuverability=manoeuvrability
maneuverable=manoeuvrable
maneuver=manoeuvre
maneuvered=manoeuvred
maneuvers=manoeuvres
maneuvering=manoeuvring
maneuverings=manoeuvrings
marshaled=marshalled
marshaling=marshalling
marveled=marvelled
marveling=marvelling
marvelous=marvellous
marvelously=marvellously
math=maths
meager=meagre
medieval=mediaeval
meter=metre
meters=metres
micrometer=micrometre
micrometers=micrometres
milligram=milligramme
milligrams=milligrammes
milliliter=millilitre
milliliters=millilitres
millimeter=millimetre
millimeters=millimetres
minibusses=minibuses
misbehavior=misbehaviour
misdemeanor=misdemeanour
misdemeanors=misdemeanours
misspelled=misspelt
miter=mitre
miters=mitres
modeled=modelled
modeler=modeller
modelers=modellers
modeling=modelling
monolog=monologue
monologs=monologues
mold=mould
molded=moulded
molder=moulder
moldered=mouldered
moldering=mouldering
molders=moulders
moldier=mouldier
moldiest=mouldiest
molding=moulding
moldings=mouldings
molds=moulds
moldy=mouldy
molt=moult
molted=moulted
molting=moulting
molts=moults
mustache=moustache
mustached=moustached
mustaches=moustaches
mustachioed=moustachioed
multicolored=multicoloured
nanometer=nanometre
neighbor=neighbour
neighborhood=neighbourhood
neighborhoods=neighbourhoods
neighboring=neighbouring
neighborliness=neighbourliness
neighborly=neighbourly
neighbors=neighbours
neuron=neurone
newsdealer=newsagent
license plate=number plate
odor=odour
odorless=odourless
odors=odours
enology=oenology
esophagus=oesophagus
esophaguses=oesophaguses
estrogen=oestrogen
offense=offence
offenses=offences
omelet=omelette
omelets=omelettes
flashlight=orch
orthopedic=orthopaedic
orthopedics=orthopaedics
outmaneuver=outmanoeuvre
outmaneuvered=outmanoeuvred
outmaneuvers=outmanoeuvres
outmaneuvering=outmanoeuvring
pederast=paederast
pederasts=paederasts
pediatric=paediatric
pediatrician=paediatrician
pediatricians=paediatricians
pediatrics=paediatrics
pedophile=paedophile
pedophiles=paedophiles
pedophilia=paedophilia
paleolithic=palaeolithic
paleontologist=palaeontologist
paleontologists=palaeontologists
paleontology=palaeontology
paneled=panelled
paneling=panelling
panelist=panellist
panelists=panellists
paralyze=paralyse
paralyzed=paralysed
paralyzes=paralyses
paralyzing=paralysing
parceled=parcelled
parceling=parcelling
parlor=parlour
parlors=parlours
sidewalk=footpath
pedaled=pedalled
pedaling=pedalling
penciled=pencilled
penciling=pencilling
persnickety=pernickety
gasoline=petrol
pharmacopeia=pharmacopoeia
pharmacopeias=pharmacopoeias
drugstore=pharmacy
filter=philtre
filters=philtres
phony=phoney
picometer=picometre
plow=plough
plowed=ploughed
plowing=ploughing
plowman=ploughman
plowmen=ploughmen
plows=ploughs
plowshare=ploughshare
plowshares=ploughshares
mailman=postman
pouf=pouffe
poufs=pouffes
practice=practise
practiced=practised
practices=practises
practicing=practising
presidium=praesidium
presidiums=praesidiums
premiere=première
pretense=pretence
pretenses=pretences
primeval=primaeval
program=programme
programs=programmes
prolog=prologue
prologs=prologues
psychoanalyze=psychoanalyse
psychoanalyzed=psychoanalysed
psychoanalyzes=psychoanalyses
psychoanalyzing=psychoanalysing
pummel=pummelled
pummeled=pummelling
pajama=pyjama
pajamas=pyjamas
pizzazz=pzazz
quarreled=quarrelled
quarreling=quarrelling
fourth=quarter
quint=quin
railroad=railway
rancor=rancour
raveled=ravelled
raveling=ravelling
recognizably=recognisably
recognizance=recognisance
reconnoiter=reconnoitre
reconnoitered=reconnoitred
reconnoiters=reconnoitres
reconnoitering=reconnoitring
refueled=refuelled
refueling=refuelling
remodeled=remodelled
remodeling=remodelling
remold=remould
remolded=remoulded
remolding=remoulding
remolds=remoulds
reveled=revelled
reveler=reveller
revelers=revellers
reveling=revelling
rigor=rigour
rigors=rigours
rivaled=rivalled
rivaling=rivalling
garbage=rubbish
rumor=rumour
rumored=rumoured
rumors=rumours
saber=sabre
sabers=sabres
sailboat=sailing boat
saltpeter=saltpetre
sanitarium=sanatorium
savior=saviour
saviors=saviours
savor=savour
savored=savoured
savories=savouries
savoring=savouring
savors=savours
savory=savoury
scalawag=scallywag
skeptic=sceptic
skeptical=sceptical
skeptically=sceptically
skepticism=scepticism
skeptics=sceptics
scepter=sceptre
scepters=sceptres
sepulcher=sepulchre
sepulchers=sepulchres
sheik=sheikh
shoveled=shovelled
shoveling=shovelling
shriveled=shrivelled
shriveling=shrivelling
signaled=signalled
signaling=signalling
simultanous=simultaneous
skillful=skilful
skillfully=skilfully
sled=sleigh
smolder=smoulder
smoldered=smouldered
smoldering=smouldering
smolders=smoulders
sniveled=snivelled
sniveling=snivelling
snorkeled=snorkelled
snorkeling=snorkelling
snowplow=snowplough
snowplow=snowploughs
somber=sombre
specialty=speciality
specter=spectre
specters=spectres
spelled=spelt
spilled=spilt
spiraled=spiralled
spiraling=spiralling
splendor=splendour
splendors=splendours
spoiled=spoilt
squirreled=squirrelled
squirreling=squirrelling
stenciled=stencilled
stenciling=stencilling
succor=succour
succored=succoured
succoring=succouring
succors=succours
sulfate=sulphate
sulfates=sulphates
sulfide=sulphide
sulfides=sulphides
sulfur=sulphur
sulfurous=sulphurous
last name=surname
swiveled=swivelled
swiveling=swivelling
siphon=syphon
siphoned=syphoned
siphoning=syphoning
siphons=syphons
tasseled=tasselled
dishtowel=tea towel
technicolor=technicolour
theater=theatre
theatergoer=theatregoer
theatergoers=theatregoers
theaters=theatres
checkbox=tickbox
pantyhose=tights
tidbit=titbit
taffy=toffee
totaled=totalled
totaler=totaller
totaling=totalling
toweled=towelled
toweling=towelling
toxemia=toxaemia
streetcar=tram
tranquilize=tranquillize
tranquilized=tranquillized
tranquilizer=tranquillizer
tranquilizers=tranquillizers
tranquilizes=tranquillizes
tranquilizing=tranquillizing
tranquility=tranquillity
tranquilize=tranquillize
tranquilized=tranquillized
tranquilizer=tranquillizer
tranquilizers=tranquillizers
tranquilizes=tranquillizes
tranquilizing=tranquillizing
tranquility=tranquilly
transportation=transport
traveled=travelled
traveler=traveller
travelers=travellers
traveling=travelling
travelog=travelogue
travelogs=travelogues
trialed=trialled
trialing=trialling
tricolor=tricolour
tricolors=tricolours
tumor=tumour
tumors=tumours
tunneled=tunnelled
tunneling=tunnelling
tire=tyre
tires=tyres
unequaled=unequalled
unfavorable=unfavourable
unfavorably=unfavourably
infeasible=unfeasible
unraveled=unravelled
unraveling=unravelling
unrivaled=unrivalled
unsavory=unsavoury
untrammeled=untrammelled
upscale=upmarket
useable=usable
valor=valour
vapor=vapour
vapors=vapours
vise=vice
videodisk=videodisc
videodisks=videodiscs
vigor=vigour
watercolor=watercolour
watercolors=watercolours
weaseled=weaselled
weaseling=weaselling
willful=wilful
willfully=wilfully
windshield=windscreen
woolen=woollen
woolens=woollens
woolies=woollies
wooly=woolly
worshiped=worshipped
worshiper=worshipper
worshiping=worshipping
yodeled=yodelled
yodeling=yodelling
